1111111111111
1CC1C00C000C1
1C0001C0000C1
1010111111001
1P10110E0C001
1111111111111
